[Example]
action=example
say=example

[WordCencor]
gila=gila|gendeng|gemblung|crazy|pea|kampret
binatang=asu|anjing|babi
lainnya=tai|taek|eek|pret|setan

[Greeting]
hi=hi|hii|hai|hei|halo|hallo|halow|hallow|hellow|hola|hox
kabar=apa kabar|kabar

[Sapaan]
aku=aku|saya|gue|gw|akyu|ane
kamu=kamu|kmu|kamyu|kau|dikau|engkau|ngkau|anda|lu|loe|ente
dia=om|mbah|pak|mas|pakdhe|kak|kakak|mas|bu|ibu|dek
kakak=kk

[Abaikan]
yuk=dong|yuk

[Tanya]
siapa=siapa|syapa|sapa
apa=apa|apakah
mengapa=mengapa|ngapa|napa
berapa=berapa|brp|brapa

[Perintah]
cari=cariin|carikan|cari|temukan

[Respon]
baik=baik|baiklah|okey|oke|okelah|sip|sipp|senang|seneng
buruk=mbuh|tauah|tauk|ga tau|ngga tau|entahlah|gaje|gajelas|karepmu|auah|au ah

[Waktu]
jam=jam
hari=hari|hr
minggu=minggu
bulan=bulan|bln
tahun=tahun|thn
tanggal=tanggal|tgl
waktu=pagi|siang|sore|malam|malem

[Kondisi]
jika=jika|kalau|kalaw|kalo|klo|apabila|bila

[RutinitasHarian]
makan=makan|mangan|maem|mkan
mandi=mandi|mndi
tidur=tidur|turu|bobo
kerja=kerja|gawe

[PersonalStatus]
nikah=nikah|menikah|merid|married
single=jomblo|single|gadis|gds|lajang|perjaka

[PersonalKnowledge]
tahu=kenal|tau|tahu|ngerti|ngertiin

[Keadaan]
good=sehat|kuat|semangat|sembuh
bad=sakit|demam|pusing

[HargaLevel]
mahal=mahal|mhal
murah=murah|mrah

[Nominal]
nominal=.*\d
range=kisaran|seharga|seputar|harga
harga=harga|hrga

[Kencantikan]
baik=ganteng|cantik|keren|hebat|powerful|top|pinter
buruk=jelek|songong|gila|budeg

[Perasaan]
tidak=benci|jijay|ga suka|ga seneng
baik=suka|demen|seneng|kesengsem|trisna|love

[Ekspresi]
baik=haha|hehe|hihi|hoho|wkwk
kaget=eehh|ehh|wow

[Figure]
presiden=soekarno|soeharto|sby|jokowi|megawati|prabowo|jkw
pahlawan=pattimura|diponegoro|kartini
jagoan123=ansori|encang|ihdi|oka|abi|ines
dev=peter|bams|bambang|anne|deroh|ratu|yudi|joko
devpascal=indra|tigor|derit

[Sedang]
sudah=sdh|sudah|sdah
sedang=sedang|sdg|lagi|lg
akan=akan|mau|mo

[Keraguan]
kok=kok|koq|lho

